############
#        O #
#   P   ####
#          #
#######    #
#  O ##    #
#    ##     
#          #
#       XX #
#       #  #
############
